AccessDenied=Nu aveti dreptul de a vedea aceasta pagina. Va rugam sa contactati administratorul.
accesslevel=Nivelul de acces
ActiveDBName=Baza de date activa
AddNew=Adaugarea
Address=Adresa
Agenda=Agenda
AllFacitlities=All factilities in database
assetcategory=Categoria dispozitivelor
assetcategoryAssetCategoryID=Categoria Dispozitivelor
assetcategoryassetgenericname=Categoria, Numele generic a dispozitivelor
AssetCategoryID=Categoria dispozitivelor
AssetCategoryName=Categoria dispozitivelor
AssetCategoryNr=Numarul categoriei
AssetFullName=Numele intreg
assetgenericname=Numele generic a dispozitivelor
assetgenericnameAssetCategoryID=Categoria dispozitivelor
AssetID=Dispozitive
AssetLocation=Localizarea
assets=Dispozitive
assets_assetgenericname=Dispozitive Numele Generic A Dispozitivelor
assetsAssetStatusID= Stautul Dispozitivelor
assetsManufacturerID=Producator
assetstatus= Stautul Dispozitivelor 
assetstatusAssetStatusID= Stautul Dispozitivelor
AssetStatusDesc=Statutul Dispozitivelor
AssetStatusID=Statut
assetsVendorID=Vinzator
assetutilization=Utilizarea Dispozitivelor
AssetUtilizationDesc=Utilizarea
AssetUtilizationID=Utilizarea
Backup=Copie de siguranta
BackupAll=Copia de siguranta a intregii baze de date
BackupUserDB=Copia de siguranta a bazei de data a utilizatorului
Building=Adresa
CCS_AdvSearchAllWords=Toate cuvintele
CCS_AdvSearchAnyOfWords=Oricare din cuvinte
CCS_AdvSearchConditionsCaption=Cautare
CCS_AdvSearchExactPhrase=Fraza exacta
CCS_ASC=Crescator
CCS_Bytes=byti
CCS_Cancel=Anulare
CCS_CannotSeek=Nu  pot gasi inscrierea specificata.
CCS_Captcha_ControlValidation=Valoare introdusa nu cerespunde cu valoare din imagine.
CCS_Clear=Curatare
CCS_CustomLinkField=Detalii
CCS_CustomOperationError_MissingParameters=Unul sau mai multi parametrii lipsesc pentru performarea schimbarilor sau stergerii. Aplicatia nu este configurata.
CCS_DatabaseCommandError=Eroarea comenzii bazei de date.
CCS_DatePickerNav61=Componenta Date Picker nu e compatibila cu Netscape 6.1
CCS_Delete=Eliminare
CCS_DeleteConfirmation=Sa elimin  inscrierea?
CCS_DESC=Descrescator
CCS_DirectoryFormPrefix=Directorie
CCS_FileNotFound=Fisierul {0} specificat in {1} nu a fost gasit.
CCS_FilesFolderNotFound=Incapabil de a incarca fisierul specificat in {0} - fisierul incarcat nu exista.
CCS_FileUpload=Fisierul incarcat.
CCS_Filter=Cuvint cheie
CCS_First=Primul
CCS_GalleryFormSuffix=Galerii
CCS_GridFormPrefix=Lista
CCS_GridFormSuffix= 
CCS_GridPageNumberError=Numar de pagina inexistent
CCS_GridPageSizeError=(CCS06) Marimea paginii inadmisibila.
CCS_IncorrectEmailFormat=Formatul emailului inacceptabil in cimpul {0}.
CCS_IncorrectFormat=Valoarea in cimpul {0} nu e valida. Utilizeaza urmatorul format: {1}.
CCS_IncorrectPhoneFormat=Formatul numarul este inacceptabil in cimpul {0}.
CCS_IncorrectValue=Valoarea in cimpul {0} nu e valida.
CCS_IncorrectZipFormat= Formaul codului zip nu e valid  in cimpul {0}.
CCS_Insert=Adaugare
CCS_InsertLink=Adauga Nou
CCS_InsufficientPermissions=Insufficient filesystem permissions to upload the file specified in {0}.
CCS_LanguageID=ro
CCS_LargeFile=Marimea fisierului in cimpul {0} e prea mare.
CCS_Last=Ultimul
CCS_LocaleID=ro
CCS_Login=Logare
CCS_Login_AutoLogin_Caption=Memoreaza
CCS_Login_Form_Caption=Logare
CCS_LoginBtn=Logare
CCS_LoginError=Loginul sau parola este incorecta
CCS_LogoutBtn=Iesire
CCS_Main=Principal
CCS_MaskValidation=Validarea mashtii a picat pentru cimpul {0}.
CCS_MaximumLength=Numarul simbolurilor in cimpul {0} nu poate depasi {1}.
CCS_MaximumValue=Valorea in cimpul {0} nu poate fi mai mare decit {1}.
CCS_MinimumLength=Numarul simbolurilor in cimpul {0} nu poate fi mai mica decit {1}.
CCS_MinimumValue=Valorea in cimpul {0} nu poate fi mai mica decit {1}.
CCS_More=Mai multe…
CCS_Next=Urmatorul
CCS_NextMonthHint=Luna Urmatoare
CCS_NextQuarterHint=Urmatorul Simestru
CCS_NextThreeMonthsHint=Urmatoarele trei luni
CCS_NextYearHint=Urmatorul an
CCS_NoCategories=Categoria nu este gasita
CCS_NoRecords=Nu sunt inscrieri
CCS_Of=din
CCS_OperationError=Imposibil de a performa operatia (0}. Unul sau mai multi parametri nu sunt specificati.
CCS_Password=Parola
CCS_Previous=Precedentul
CCS_PrevMonthHint=Precedenta Luna
CCS_PrevQuarterHint=Simestrul Precedent
CCS_PrevThreeMonthsHint=Trei luni precedente
CCS_PrevYearHint=Anul precedent
CCS_RecordFormPrefix=Adaugare/Editare
CCS_RecordFormPrefix2=Vizualizare
CCS_RecPerPage=Inscriere pe pagina
CCS_RememberLogin=Memoreaza loginul si parola
CCS_ReportPageNumber1=Pagina
CCS_ReportPageNumber2=de
CCS_ReportPrintLink=Versiune printabila
CCS_ReportSubTotal=Sub Total
CCS_ReportTotal=Grand Total
CCS_RequiredField=Valoarea in cimpul {0} e solicitata.
CCS_RequiredFieldUpload=Fisierul atasat in cimpul {0} e solicitat.
CCS_RequiredSMTPserver_or_Dir=Va rugam sa specificati SMTP serverul sau directoria Pickup pentru CDO.
CCS_Search=Cautare
CCS_SearchFormPrefix=Cautare
CCS_SearchFormSuffix= 
CCS_SelectField=Selecteaza cimpul
CCS_SelectOrder=Selecteaza ordinea
CCS_SelectValue=Selecteaza
CCS_SortBy=Sorteaza dupa
CCS_SortDir=Directia de sortare
CCS_SubmitConfirmation=Salveaza inscrierea?
CCS_TempFolderNotFound=Imposibil de incarcat fisierul specificat in {0} - temporar fisierul uncarcat nu exista.
CCS_TempInsufficientPermissions=Insuficienta permisiunea sistemului pentru a incarca fisierul specificat in {0} in mapa declarata.CCS_Today=Astazi
CCS_TotalRecords=Totalul inscrierilor
CCS_UniqueValue=Valoarea in cimpul {0} deja exista in baza de date.
CCS_Update=Salveaza
CCS_UploadComponentError=Eroarea a aparut la initializarea incarcarii componentei.
CCS_UploadComponentNotFound={0} componenta incarcata {1} si nu a fost gasita. Va rugam sa instalati componenta sau sa selectati alta.
CCS_UploadingError=O erroarea a aparut in cursul incarcarii fisierului specificat in {0}. Eroarea descrisa: {1}.
CCS_UploadingTempFolderError=O eroare a aparut la incarcarea fisierului specificat in {0} in mapa temporara. Eroarea descrisa: {1}.
CCS_WrongType=Tipul fisierului specificat in cimpul {0} nu e permis.
ChangeLanguage=Schimbarea limbei
ChooseProviderProtocol=Alege furnizorul și protocol
City=Oras
CloseWindow=Inchide fereastra
ColorScheme=Seteaza culoarea schemei
contact=Contacte
ContactID=Contacte
ContactName=Denumirea intreprinderii
ContactPersonName=Nume personal
contacts=Dispozitive
ContactTitle=Postul
contacttype=Tipul de contact
ContactTypeID= Tipul de contact
ContactTypeName=Nume
Contractor=Contractor
Count=Numara: 
countries=Tari
countries_districts=Raionul
countriesCountryID=Stat
Country=Stat
CountryID=Stat
CurrentUser=Utilizatorul curent
CurrentValue=Valoarea curenta
DatabaseVersion=Versiunea bazei de date
Day=zi
DBSize=Dispozitivele in baza de date
DefaultDB=Baza de Date
DefaultTime=10:00:00
Delete=Import
DeleteUserData=Eliminarea tuturor utilizatorilor 
department=Department
DepartmentDesc=Department
DeptID=Departamentul
DesignBy=Creat de
DeviceCategoryID=Categoria Dispozitivului
DeviceCategoryName=Numele categoriei a dispozitivului
DeviceCategoryNr= Numarul categoriei a dispozitivului
District=Raion
DistrictID=Raion
DistrictName=Denumirea raionului
districts=Raioane
districts_countries=Rioanele Statelor
districtsDistrictID=Raioane
Duplicate=Dubla introducere
Email=E-Mail
EmployeeID=Angajat
employees=Angajati
EnlargePicture=marimea intreaga
EntireDatabase=Intreaga Baza de Date
essential_equipment=Echipament Essential
EssentialEqipment=Echipament Essential de Acoperire
EssentialEquipment=Lista Echipamentelor Esentiale
EssentialLibrary=Bibliotecile Esentiale
EssetialEquipmentBalance=Balanta Echipamentelor Essentiale
ExportToExcel=Export this table to MS Excel
F21Ultrasound22weeks=Кількість вагітних, які пройшли УЗ обстеження до 22 тижнів вагітності
facilities=Spital
facilitiesFacilityID=Spital
FacilityID=Spital
FacilityName=Denumirea Spitalului
Fax=Fax
FaxNumber=Numarul Faxului
file_date_uploaded=Date Incarcate
file_name=Nume
files=Fisiere
FinanceStats=Statutul Financiar
FirstName=Numele
Floor=Etajul
FormatMySQL=mySQL
GenericAssetCode=Codul generic a Dispozitivelor
GenericAssetID=Dispozitive Generice
GenericAssetImage=Imaginea Dispozitivelor
GenericAssetName=Numele generic a Dispozitivelor
GenericDeviceCode=Codul Generic a dispozitivelor
GenericDeviceID=Dispozitive Generice
GenericDeviceName=Numele generic a dispozitivului
GroupID=Grupa
HandPhone=Mobil
HHospitalisation=Госпіталізацію
HighRiskPregnanciesSummary=Ridicat de risc Sarcinile Rezumat (pentru utilizatori regionale)
HighRiskPregnanciesSummaryDayOfMonth=Ziua de luni pentru a trimite o notificare (ziua 1-28)
HighRiskPregnancySummary=Notificări Sarcina Sumar ridicat de risc
HTMGeneral=Managementul general a tehnologiilor din sanatate.
Id=Id
ImportDelete=Sterge toate datele existente inainte de importare.
ImportOnly=Importeaza si adauga la datele existente
ImportReplaceDB=Importeaza si schimba baza de date existenta
ImportUserData=Importeaza baza de date a utilizatorului
IndexTitle=Open MEDIS - O sursa deschisa a sistemelor informationale de dispositive medicale in tari medii si slab dezvoltate. 
InternalIventoryNumber=Numarul inventarului intern
LastName=Prenume
LastUpdated=Ultima inoire
ListofAssets=Lista Dispozitivelor selectate
Location=Localizarea
locationFacilityID=Spitale
LocationID=Localizare
login=Logare
LoginID=Logare
LogoutText=Iesire cu succes
ManufacturerID=Producator
ManufacturerSupplierCode=Cod
MenuAdmin=Administrarea
menuassetlist=Lista Dispozitivelor
menuassets=Dispozitive
MenuConfigure=Configurare
MenuHome=Acasa
menuinventory=Inventar
MenuList=Lista
menulocations=Localizari
menuoverview=Prezenatre generala
menureports=Repoarte
menutextassets=Dispozitive
menutextoverview= Prezenatre generala
MenuTools=Unelte
MinimalQuantity=Cantitate minima
Model=Model
myAccount=Contul meu
MySQLDatabase=MySQL Database
NewRecord1=Inscrierea Noua1
NewReport1=Inscrierea Noua1
Notes=Informatie Suplimentara
NotetoTech=Note la tehnologii
NotificationInvalidTimeFormat=Vă rugăm să folosiți un format de timp valid.
notificationkeywords=Utilizați următoarele cuvinte cheie pentru fiecare tip de notificare:
notificationkeywordsHighriskpregnancysummary=Memento-uri vizita de mare risc pentru medici: [report], , [reportdate]
notificationkeywordspatientdischargedreferral=Pacient externat din spital de sesizare: [patientname], [doctorname] , [facilityname], [dischargedate]
notificationkeywordsreminders=Memento-uri pentru pacienți: [facilityname], [visitdate], [patientname]
notificationkeywordsremindersfordoctors=Memento-uri vizita de mare risc pentru medici: [facilityname], [visitdate], [patientname], [doctorname]
NotificationNote=Va rugam sa dezactivati ​​dacă pacientul este folosind aplicația MCH-registru mobil.
notifications=Notificări
NotificationsDayOfMonth=Ziua de luni trebuie să fie de cel puțin 1 an nu poate fi mai mare de 28.
NotificationsDaysAfter=Zile de la data trebuie să fie de cel puțin 1 an nu poate fi mai mare de 20.
NotificationsDaysinAdvHighRiskReminders=Zile în avans, pentru Memento-uri de mare risc ar trebui să fie Intre 1 si 15.
notificationsedit=Texte Editare notificare
notificationsettings=Setări de notificare
notificationsettingsnote=Pentru toate instalațiile fără propriile setări, Wil fi utilizate setările implicite ale aplicației.
NotificationsReminderDaysinAdvance=Zile în avans, pentru Memento-uri ar trebui să fie Intre 1 si 15.
notificationssmsconfiguration=Configurarea SMS Servicii
NotificationType=notificarea Tip
nProtocol=Protocol
nProvider=furnizorul
OutputFormat=Formatul de iesire
password=Parola
PatientDischargedReferral=Pacient externat din spital de sesizare (pentru medici)
PatientDischargedReferralDaysAfter=Trimite notificare x zile dupa descarcarea de gestiune
Percent=Procente: 
PhoneNumber=Numarul de telefon
PictureFullSize=[full size]
Position=Positia
PostalCode=Codul postal
PreviousDeliveries=Попередні пологи
PurchaseDate=Data procurarii
PurchasePrice=Pretul cumparaturii
RecommendationNot=Notificări de recomandare
RecommendationNotifications=Notificări de recomandare
Recommendations=Recomandări
recommendationsnotificationsedit=Edit Recomandarea
ReminderNot=Notificări memento
Reminders=Memento-uri
RemindersDaysInAdv=Numărul de zile pentru a trimite o notificare in prealabil
RemindersHighRisk=Memento-uri pentru vizite de sarcina cu risc ridicat (pentru medici)
Replace=Inlocuire
Report_Manufacturers_Suppliers=Manfuacturers and Suppliers Report
room=Incapere
Roomdesc=Descrirea Incaperii
RoomID= Incapere
Roomnb=Numarul Incaperii
SelectLanguage=Limba
SerialNumber=Numarul de Serie
Services=Servicii
StateOrProvince=Stat
Status=Statut
SubscribeMessage=Aboneaza-te Mesaj
Sum=Suma: 
Supplier=Furnizorul
SupplierContactID=Contacte
SupplierID=Furnizorul
SupplierIDList=Furnizorul
SupplierName=Nume
Suppliers=Furnizori
suppliervendor=Furnizor
SWVersion=Versiunea Software
TechnicianYN=Technician YN
Text=text
TimeToSend=Timp pentru a trimite o notificare
Today=Astazi
UMDNS=Codul SUNDM 
UnsubscribeMessage=Mesaj dezabonare
UploadImages=Incarca Imaginea
UploadUserImages=Incarca imaginea utilizatorului
UserData=Date utilizator
username=Nume Utilizator
Utilization=Utilizare
Vendor=Vinzator
VendorIDList=Vinzator
Warranty=Garantie
WarrantyContract=Garantia sau Contractul
WarrantyContractExp=Data Expirarii Garantiei
WarrantyContractID=Garantie sau contract
WarrantyContractNotes=Garantia sau Contractul 
WorkPhone=Telefonul de serviciu
ValidInputForNotifications=Timp valabil: Între 06:00 și 22:00 la fiecare jumătate de oră. <br>\nZi valabil (e) în avans / înainte: 1-7 zile.
gsmSMS=GSM SMS
unicodeSMS=Unicode SMS
charactersRemaining=caractere rămase 
approxRemaining=Apropierea numai în cazul în care sunt utilizate cuvinte cheie!
notificationkeywordssubscribeunsubscribe=Aboneaza-te și Dezabonare: [patientname], [doctorname] , [facilityname]
Unsubscribe=Notificarea dezabonare
Subscribe=Aboneaza-te Notificare
SubscribeDaysAfter=Trimite x zile de abonament
UnsubscribeDaysAfter=Trimite x zile de dezabonare
NotificationID=ID
