Abnormal_Test_Results=Результат теста неприемлемый
AbnormalTestResults=Отклонение от нормы по результатам теста
AcceptedBy=Принято
AccessDenied=Вы не можете видеть эту страницую Пожалуйста
accesslevel=Уровень доступа
ActDateEnd=Окончание срока действия
ActDateStart=Начало срока действия
ActionTaken=Предпринятые меры
ActiveDB=Активная база данных
ActiveDBName=Активная база данных
AddEditAdministeredMedication=Добавить/Редактировать примененные медикаменты
AddEditMedications=Добавить/Редактировать медикаменты
AddEditPatient=Добавить/Редактировать пациента
AddEditPregnancy=Добавить/Редактировать беременность
AddEditRecommendedMedication=Добавить/Редактировать назначенные медикаменты
AddEditTest=Добавить/Редактировать тест
AddNew=Добавить новый
Address=Адрес
AddressDifference=Фактический адрес отличается от адреса прописки
AddressRegistered=Адрес прописки
AdministeredMedications=медикаменты
AdminMedication=примененные медикаменты
AdmissionDate=Дата поступления
Admitted=Прибыла из другого района/области
AdmMedications=Примененные медикаменты
Agenda=План
All=Всего
AllFacitlities=Все объекты в базе данных
AllPwdFieldsEnt=Необходимо заполнить все поля, чтобы изменить пароль
ALVdays=ШВЛ (дн.)
AmnioticBursting=Период разрыва оболочек
AnatomicPathology=Диагноз патологоанатомический
Anesthesia_applied=Примененные анастезии
Anesthesia_list=Список анастезий
antCondIncHosp=Дородовые условия (включая госпитализацию)
Antenatal_Conditions=Антенатальные заболевания
AntenatalActivity=Деятельность женских консультаций
AntenatalProblemsList=Антенатальные проблемы
Antibiotics=Антибиотики
Apgar1=Оценка по Апгар 1 мин. меньше 0 или больше 10
Apgar5=Оценка по Апгар 5 мин. меньше 0 или больше 10
ApgarScore1min=Оценка по Апгар 1 мин.
ApgarScore5min=Оценка по Апгар 5 мин.
AppliedBreastID=Прикладывание к груди
ART=АРП
AssEndDate=Срок окончания оценки
assetcategory=Категория оборудования
assetcategoryAssetCategoryID=Категория оборудования
assetcategoryassetgenericname=Категория оборудования, Общее название оборудования
AssetCategoryID=Категория оборудования
AssetCategoryName=Категория оборудования
AssetCategoryNr=Номер категории
AssetFullName=Полное название
assetgenericname=Общее название оборудования
assetgenericnameAssetCategoryID=Категория оборудования
AssetID=Оборудование
AssetLocation=Место расположения
assets=Оборудование
assets_assetgenericname=Оборудование Общее название
assetsAssetStatusID=Состояние оборудования
assetsManufacturerID=Производитель
assetstatus=Состояние оборудования
assetstatusAssetStatusID=Состояние оборудования
AssetStatusDesc=Состояние оборудования
AssetStatusID=Состояние
assetsVendorID=Продавец
assetutilization=Использование оборудования
AssetUtilizationDesc=Использование
AssetUtilizationID=Использование
AutomAddVisitIfAddPreg=После того, как Вы создали запись новой беременности, Вы можете добавить информацию о первом визите на следующей странице.
average=Средние показатели койкодня
Average1=Средний койкодень пребывания в родильном отделении
Average2=Средний койкодень пребывания после родов
Average3=Средний койкодень пребывания после Кесарево сечения
BabiesName=Кол-во детей
Backup=Резервная копия
BackupAll=Резервная копия всей базы данных
BackupUserDB=Резервная копия базы данных пользователя
Bad_Habits=Вредные привычки
BadHabbits=Другие факторы риска
before_labor=Смерть наступила до начала родовой деятельности
Birth_Date=Дата рождения
Birth_weight=Маса тела меньше чем 0 или больше чем 6 кг.
BirthDate=Дата рождения
BirthDateTime=Дата и время рождения
BirthDayPregnant=Дата рождения беременной
BirthTime=Время рождения
BloodGroup=Группа крови
BloodGroupID=Группа крови
born=новорожденного
boy=мальчик
branch_employees_faciliti=Сотрудники отделения
BranchName=Имя
BreastFeedingID=Прикладывание к груди
Building=Здание
Calc_DeliveryDate=Ожидаемая дата родов
Calculate=Подсчитать
CauseDescription=Описание причин
CCS_AdressActual=Вы отметили, что актуальный адрес отличный от паспортного
CCS_AdvSearchAllWords=Все слова
CCS_AdvSearchAnyOfWords=Любое из слов
CCS_AdvSearchConditionsCaption=Искать как
CCS_AdvSearchExactPhrase=Фразу целиком
CCS_ASC=По возрастанию
CCS_Bytes=байт
CCS_Cancel=Отменить
CCS_CannotSeek=Невозможно перейти к записи.
CCS_Captcha_ControlValidation=Указанное значение не соответствует значению на изображении
CCS_Clear=Очистить
CCS_CustomLinkField=Детали
CCS_CustomOperationError_MissingParameters=Один или более параметров не заданы для обновления или удаления. Приложение неверно сконфигурировано.
CCS_DatabaseCommandError=Ошибка базы данных.
CCS_DatePickerNav61=Компонент Date Picker работает некорректно с Netscape 6.1
CCS_Delete=Удалить
CCS_DeleteConfirmation=Удалить запись?
CCS_DESC=По убыванию
CCS_DirectoryFormPrefix=Директория
CCS_DirectoryFormSuffix= 
CCS_FileNotFound=Файл {0}, заданный в поле {1}, не найден.
CCS_FilesFolderNotFound=Невожможно загрузить файл, заданый в поле {1} - директория для загрузки файлов не существует.
CCS_FileUpload=Загрузка файла
CCS_Filter=Ключевое слово
CCS_First=Первый
CCS_GalleryFormSuffix=Галерея
CCS_GridFormPrefix=Список:
CCS_GridFormSuffix= 
CCS_GridPageNumberError=Неправильный номер страницы.
CCS_GridPageSizeError=(CCS06) Неправильный размер страницы.
CCS_IncorrectEmailFormat=Недопустимый email-формат для поля {0}.
CCS_IncorrectFormat=Недопустимое значение для поля {0}. Используйте следущий формат: {1}.
CCS_IncorrectPhoneFormat=Недопустимый формат телефонного номера для поля {0}.
CCS_IncorrectValue=Недопустимое значение для поля {0}.
CCS_IncorrectZipFormat=Недопустимый формат почтового индекса для поля {0}.
CCS_Insert=Добавить
CCS_Insert_NewBorn=новорожденного
CCS_InsertLink=Добавить
CCS_InsertNewBorn=новорожденного
CCS_InsufficientPermissions=Недостаточно прав для загрузки файла, заданого в поле {0}.
CCS_LanguageID=ru
CCS_LargeFile=Файл в поле {0} слишком велик.
CCS_Last=Последняя
CCS_LocaleID=ru
CCS_Login=Логин
CCS_Login_Form_Caption=Login
CCS_LoginBtn=Логин
CCS_LoginError=Неправильный логин или пароль.
CCS_LogoutBtn=Выход
CCS_Main=Главная
CCS_MaskValidation=Значение поля {0} несоотвествует маске.
CCS_MaximumLength=Длина поля {0} не может превышать {1} символов.
CCS_MaximumValue=Значение поля {0} не может быть больше чем {1}.
CCS_MinimumLength=Длина поля {0} не может быть менее {1} символов.
CCS_MinimumValue=Значение поля {0} не может быть меньше чем {1}.
CCS_More=Далее...
CCS_Next=Следующая
CCS_NextMonthHint=Следующий месяц
CCS_NextQuarterHint=Следующий квартал
CCS_NextThreeMonthsHint=Следующие 3 месяца
CCS_NextYearHint=Следующий год
CCS_NoCategories=Категории не найдены
CCS_NoRecords=Нет записей
CCS_Of=из
CCS_OperationError=Невозможно выполнить операцию {0}. Один или более параметров не заданы.
CCS_Password=Пароль
CCS_Previous=Предыдущая
CCS_PrevMonthHint=Предидущий месяц
CCS_PrevQuarterHint=Предидущий квартал
CCS_PrevThreeMonthsHint=Предидущие 3 месяца
CCS_PrevYearHint=Предидущий год
CCS_RecordFormPrefix=Добавить/Редактировать
CCS_RecordFormPrefix2=Просмотр
ccs_recordformsuffix= 
CCS_RecPerPage=Записей на стр.
CCS_RememberLogin=Запомнить мой Логин и Пароль
CCS_ReportFormPrefix= 
CCS_ReportFormSuffix=Область/Район
CCS_ReportPageNumber1=Страница
CCS_ReportPageNumber2=из
CCS_ReportPrintLink=Версия для печати
CCS_ReportSubTotal=Sub Total
CCS_ReportTotal=Всего
CCS_RequiredField=Значение поля {0} является обязательным.
CCS_RequiredFieldUpload=Файл в поле {0} должен быть задан.
CCS_RequiredSMTPserver_or_Dir=Пожалуйста задайте SMTP сервер или директорию с письмами для компонента CDO.Message.
CCS_Search=Искать
CCS_SearchFormPrefix=Поиск по
CCS_SearchFormSuffix=по
CCS_SelectField=Выберите поле
CCS_SelectOrder=Выберите направление
CCS_SelectValue=Выберите значение
CCS_SortBy=Сортировать по
CCS_SortDir=Направление сорт.
CCS_SubmitConfirmation=Внести записи?
CCS_TempFolderNotFound=Невозможно загрузить файл, заданый в поле {0} - директория для временных файлов не существует.
CCS_TempInsufficientPermissions=Недостаточно прав для загрузки файла, заданого в поле {0}, в директорию с временными файлами.
CCS_Today=Сегодня
CCS_TotalRecords=Всего записей:
CCS_UniqueValue=Значение поля {0} уже существует в базе данных.
CCS_Update=Обновить
CCS_UploadComponentError=Ошибка инизиализации компонента загрузки файлов.
CCS_UploadComponentNotFound=Компонент {0} для загрузки файлов не найден. Пожалуйста, установите компонент или выберите другой.
CCS_UploadingError=При загрузке файла, заданого в поле {0}, произошла ошибка. Описание ошибки: {1}.
CCS_UploadingTempFolderError=Произошла ошибка при загрузке файла, заданого в поле {0}, во временную директорию. Описание ошибки: {1}.
CCS_WrongType=Невозможно загрузить файл, заданый в {0}, поскольку загрузка файлов такого типа запрещена.
ChangeLanguage=Изменить язык
charactersRemaining=остальные символы 
ChooseProviderProtocol=Выберите поставщика и протокол
Circumference=Охват головы (см.)
City=Город
Clinical_Information=Клиническая информация
ClinicalDiagnosis=Клинический диагноз
ClinicalInformation=Клиническая информация
ClinicalRecommendations=Клинические рекомендации
ClinicalTests=Клинические осмотры
CloseWindow=Закрыть окно
CommonStay=Совместное пребывание
ComplicationDiseasesList=Осложнение родов
ComplicationsAfterDelivery=Послеродовые осложнения
ComplicationsDuringDelivery=Осложнения во время родов
ComplicationsID=Осложнения
ConfirmDeleteVisit=При удалении визита автоматически удаляется информация о медикаментах и тесты к этому визиту. Вы действительно хотите удалить визит?
confirmNewPassword=Подтвердить новый пароль
ConsulIndicationID=Показания к консультации
contact=Контакт
contact_countries_distric=Контакт Страны Район
contactcountriesdistrictsprovince=Контакт
contactDistrictID=Район
ContactID=Контакт
ContactName=Имя контакта
ContactPersonName=Имя человека
contacts=Оборудование
ContactTitle=Наименование
contacttype=Тип контакта
ContactTypeID=Тип контакта
ContactTypeName=Наименование
Contractor=Подрядчик
Count=Индекс:
countries=Страны
countries_districts=Учреждения
countriesCountryID=Страна
Country=Страна
CountryID=Страна
CPAPdays=СРАР (дн.)
created=Созданный
CurPwdInc=Текущий пароль неверный
currentPassword=Текущий пароль
CurrentUser=Текущий пользователь
CurrentValue=Текущая стоимость
DatabaseVersion=Версия базы данных
DataDelivery=Дата родов
Date=Дата
DateDelivery=Дата родов
DateDeliveryDuringHospitalisation=Дата родов
DateHandover=Дата приемки-передачи
DateReceived=Дата поступления
DateReferral=Дата направления
DateTimeOutcome=Дата и время
Day=день
DBSize=Оборудование в базе данных
DefaultDB=База данных
DefaultTime=10:00:00
Delete=Импорт
DeleteUserData=Удалить все данные пользователя
delivery=Роды
delivery_deliverymethod_district=Метод родоразрешения
delivery_deliverymethod_facility=Метод родоразрешения
delivery_deliverytype_fac=Доставка
Delivery_method_inAll_facilities=Метод родоразрешения во всех учреждениях
Delivery_types_inAll_facilities=Тип родов во всех учреждениях
DeliveryDateFacilityReferral=Роды по учреждению (включая направления)
DeliveryDuringHospitalisation=Роды во время госпитализации
deliveryfacilities=Физиологические роды
DeliveryHospital=Родовая помощь в стационаре
DeliveryInfo=Информация о родах
DeliveryList=Перечень родов
Deliverym=роды
deliverymal=роды
DeliveryMethodID=Метод родоразрешения
DeliveryMethodName=Метод родоразрешения по учреждениям
DeliveryOutcomeNote=Таблица включает беременности не больше тройни
DeliveryPerFacilityReferrals=Роды по учреждению (влючая направления)
deliverys=родов
DeliveryType=Вид родов
DeliveryTypeID=Тип родов
DeliveryTypeName=Тип родов
DeliveryTypePerFacility=Тип родов по учреждениям
department=Отделение больницы
department_employees_faci=Сотрудники отделения
DepartmentDesc=Отделения
departmentfacilitieshospitalisation=госпитализация
DepartmentID=Отделения
DeptID=Отделения
DesignBy=Разработанный
DeviceCategoryID=Категория устройства
DeviceCategoryName=Название категории устройства
DeviceCategoryNr=№ категории устройства
DiagnosedComplicationPatientDiseases=Осложнения родов пациента
DiagnosedPatientDiseases=Заболевание пациента
DiagnosedPComplicationPatientDiseases=Послеродовые осложнения пациента
Died=Умер
Died_7_27=Умерло в возрасте 7-27 суток
died_during_0_6=Умерло в возрасте 0-6 суток
Died_total=Умерло - всего
Discharged=Убыла на роды
DischargeDate=Дата выписки
DischargeDate1=Дата убытия
DischargeDate2=Дата убытия
DischargeDateTime=Дата и время выписки
DischargeDiagnosis=Диагноз пациента при выписке
DischargeInformation=Информация о выписке
disease=Болезнь
DiseaseID=Болезнь
DiseaseName=Код МКБ-10 или название заболевания
District=Район
DistrictID=Район
DistrictName=Название района
districts=Районы
districts_countries=Районы сраны
districtsDistrictID=Район
Doctor=Врач
doctorname=Имя врача
doctors=Врач
doctorsF21=Врачи без логинов
DoctorsList=врачей
Dosage=Доза
Duplicate=Двойной запас
DurationDays=Длительность (дн.)
Edit=Редактировать
EditToolTip=Редактировать
EducationID=Образование
Email=E-Mail
employee_sec_locationlocation=Другое месторасположение служащего
EmployeeID=Служащий
employees=Служащие
employees_EmployeeID=Врач
employees_LocationID=месторасположение
employees_patient_pregnan=по
employeesF21=Пользователи с логинами
EnlargePicture=Полный размер
EntireDatabase=Полная база данных
ErorOutcome2=2-й новорожденный несоответствующий результат
ErrorDeliveryMethod=Метод пологорозришення не соответствует исхода беременности (первый новорожденный)
ErrorDeliveryType=Тип родов не соответствуют результату беременности (первый новорожденный)
ErrorOutcome3=3-й новорожденный несоответствующий результат
essential_equipment=Необходимое оборудование
EssentialEqipment=Необходимый объем оборудования
EssentialEquipment=Перечень необходимого оборудования
EssentialEquipmentID=Перечень необходимого оборудования
EssentialLibrary=необходимая библиотека
EssetialEquipmentBalance=Необходимый баланс оборудования
EstDateEnd=Дата окончания
EstDateStart=Дата начала
ExportToExcel=Экспорт таблицы в MS Excel
F21=Статистические отчеты (Ф21)
F21_During=Отдельные заболевания, которые были или появились во время беременности
F21abortions=Количество самовольных абортов до 22 недель
F21alfafetoprotein=Количество беременных, обследованных на альфафетопротеин
F21AntenatalClinicactivity=ДЕЯТЕЛЬНОСТЬ ЖЕНСКОЙ КОНСУЛЬТАЦИИ
F21Blood=Заболевания системы кровообращения
F21ConditionDescription=Анемии
F21Diabetes=Сахарный диабет
F21eclampsia=В том числе прееклампсия и экслампсия
F21Edemas=Отеки, протеинурия и гипертензивные расстройства
F21HBsAg=Количество беременных, обследованных на НВsАg
F21Hemorrhage=Кровотечение, связанное с нарушением свертываемости крови
F21HIV=Количество беременных, обследованных на СПИД
F21HIV_positive=Количество беременных, которые имеют ВИЧ позитивный статус
F21HIV_tested_twice=Количество беременных
F21Others=Остальные
f21PregnanciesObserved=Количество беременных, которые были под наблюдением других учреждений
F21RWpositive=Количество беременных, которые имели позитивную реакцию Вассермана
F21RWtested=Количество беременных, обследованных дважды на реакцию Вассермана до 30 недель беременности
F21SevereEclampsia=Из них тяжелая прееклампсия и эклампсия
F21StatisticalReports=Статистические отчеты, Ф21
F21stillbirths=Количество мертворожденных
F21Thyroid=Заболевания щитовидной железы
F21Total_number_pregnancies=Всего беременных под наблюдением консультации
F21Ultrasound22weeks=Количество беременных, которые прошли УЗ обследование до 22 недель беременности
F21Urinary=Инфекции мочеполовой системы
F21Venous=Венозные осложнения во время беременности
F_Address=Фактический адрес другой
facilities=Учреждения
facilities_hospitalisatio=Госпитализация
facilitiesFacilityID=Учреждение
Facility=Учреждение
FacilityID=Учреждение
FacilityName=Название учреждения
Factor=Фактор
FamilyName=Фамилия
FamilyNamePatient=Фамилия пациента
Fax=Факс
FaxNumber=Номер факса
FeedingID=Выкармливание
file_date_uploaded=Дата загрузки
file_name=Имя
files=Файлы
FinanceStats=Финансовый статус
first_time_deliveries=Количество женщин, которые рожают впервые
FirstChild=первый новорожденный
FirstName=Имя
FirstNameDoctor=Имя врача
FirstNamePatient=Имя, отчество
FirstNamePatient1=Имя и отчество пациента
Floor=поверх
FollowUpMedication=назначенные медикаменты
FormatMySQL=mySQL
FormulaDueDate=* Расчитывается как +40 недель или 280 дней от даты последней менструации
from=От
FurtherChildren=больше трех новорожденных
GenericAssetCode=Общий код оборудования
GenericAssetID=Общее название
GenericAssetImage=Типовое изображение оборудования
GenericAssetName=Общее название
GenericDeviceCode=Общий код устройства
GenericDeviceID=Общее устройство
GenericDeviceName=Общее название
gestation12weeks=Количество беременных, которые встали на учет до 12 недель
GestationAge=Гестационный возраст (нед.)
Gestational_Limit=Гестационный возраст [нед.] Меньше 0 или больше 46
GestationDate=Гестационная дата
girl=девочка
GivenName=Имя и отчество
GivenNamePatient=Имя и отчество пациента
GroupID=Группа
gsmSMS=GSM SMS
HandPhone=Телефон
Head_circumference=Окружность головы меньше 0 или больше 50 см.
HHospitalisation=Госпитализация
HighRiskPregnanciesSummary=Беременность высокого риска Основная (для региональных пользователей)
HighRiskPregnanciesSummaryDayOfMonth=День месяца отправить уведомление (день 1-28)
HighRiskPregnancySummary=Патология Основная Уведомления
HomePhone=Домашний телефон
HospAdmDiag=Госпитализация. Диагноз при поступлении
HospAssociatedWillBeRemovedDoYouWantCont=Госпитализация, которая привязана к этому визиту, будет удалена. Вы желаете продолжить?
HospDiscDiag=Госпитализация. Диагноз при выписке
HospitalAdmData=Дата госпитализации
HospitalDischDate=Дата выписки
hospitalisation=госпитализацию
HospitalisationInformation=Информация о госпитализации
hospitalisationpregnancypatientfacilities=Госпитализации
Hospitalisations=госпитализаций
hospitalization=госпитализацию
HTMGeneral=Управление медицинскими технологиями
icd10_all=МКБ-10
ICD10_Category_Name=МКБ-10 Категория
ICD10_Subcategory_Name=МКБ-10 Подкатегория
ICD10Code1=Код МКБ-10
Id=Id
ImportDelete=Удалите все существующие данные перед импортом
ImportOnly=Импорт и присоединение к существующим данным
ImportReplaceDB=Импорт и замена всей базы
ImportUserData=Импорт в базу пользователя
IndexTitle=С открытым кодом электронного реестра для беременных женщин
IndicationID=Показания для направления
Indications=Показания
Information=Информация отображаеться за последние 3 месяца!
InternalIventoryNumber=Внутренний инвентарный номер
LastMensesDate=Дата последней менструации
LastName=Фамилия
LastNameDoctor=Фамилия врача
LastNamePatient=Фамилия
LastNamePatient1=Фамилия пациента
LastUpdated=Обновленные
LastVisit=Последний визит
latestnews=Последние новости
left_the_facilityF21=Количество беременных, которые убыли из наблюдения
Lenght=Длинна тела (см.)
Length_less=Длина тела меньше 0 или больше чем 70 см.
Library=Библиотека
LineNumber=Номер строки
ListHospitalization=Перечень госпитализаций
ListofAdminMedications=Перечень примененных медикаментов
ListofAssets=Перечень выбранного оборудования
ListofDelivery=Перечень родов
ListOfVisits=Перечень визитов
ListRecomFollowUpMedication=Перечень назначенных медикаментов
Location=Место пребывания
locationFacilityID=Учреждение
LocationID=Место пребывания
login=Логин
LoginID=Логин
LoginReq=Имя пользователя должно состоять минимум из 6-и символов и содержать хотя бы одну маленькую букву и одну цифру
LogoutText=Вы успешно вышли из системы
Man=м
ManufacturerID=Производитель
Manufacturers=Производители
ManufacturerSupplierCode=Код
MarritalStatusID=Семейное положение
MCHRegistryManual=Инструкция пользователя
Medical_Anamnesis=Медицинский анамнез
Medication=Медикаменты
Medication_List=Перечень медикаментов
MedicationID=ID
MedicationLink=Назначение медикаментов
medicationm=медикаменты
MedicationName=Название медикамента
MedicationsApplied=Примененные медикаменты
Medicationss=Медикаментов
MenuAdmin=Администрация
menuassetlist=Перечень оборудования
menuassets=Оборудование
MenuConfigure=Конфигурация
MenuHome=Домой
menuinventory=Инвентаризация
MenuList=Перечень
menulocations=Место расположения
menuoverview=Короткий осмотр
menureports=Отчеты
menutextassets=Оборудование
menutextoverview=Короткий осмотр
MenuTools=Инструменты
MethodFertilization=Метод оплодотворения
mg=мг
MinimalQuantity=Минимальное количество
MobilePhone=№ моб.тел.
Model=Модель
multiple_pregnancies=Количество многоплодных родов
myAccount=Моя учетная запись
MySQLDatabase=MySQL Database
Name_of_disease=Название заболевания
NeonatalIntensiveCareUnit=Интенсивная терапия
Newborn=новорожденного
newborn1=новорожденных
NewBorn2=Общее количество
Newborn_report=Распределение новорожденных по масе тела при рождении
NewbornData=Данные о новорожденном
NewBornID=ID
NewBornInformation=Информация о новорожденном
NewBornN=Идентификационный № н/н
NewBornOutcomeID=Результат
NewConfNotMatch=Новый пароль и подтверждение не совпадают
newPassword=Новый пароль
NewRecord1=Новая запись 1
NewRecord2=Новая запись 2
NewReport1=Новый отчет 1
news24092012=<u>Новости на главной странице (21.10.2013 р.)</u><p>\n<b><u>Короткий обзор главных изменений:</u></b><br>\n\n<ol><li>Программа переведена на русский язык. Теперь программа доступна на таких языках: укр., рус, англ..\n<li>Добавлены новые отчеты в меню «Отчеты» - «Статистические отчеты Ф21»:\n</li><ul><li>«Деятельность женских консультаций»\n<li>«Распределение новорожденных по масе тела при рождении».\n</li><li>«Родовая помощь в стационаре», который включает:\n</li><ul><li>«Количество многоплодных родов, с фильтром по возрасту»\n<li>«Количество женщин, которые рожают впервые, с фильтром по возрасту»\n</ul><li>«Усложнение родов»,\n</li><li>«Послеродовые осложнения»,\n</li><li>«Отдельные заболевания, которые были или появились во время беременности».\n</li></ul><li>Добавлены новые отчеты в меню «Отчеты» - «Статистические отчеты»:\n</li><ul><li>«Информация о родах» (тип и метод родов, партнерские роды, использование партограмм, физиологические роды и результат беременности).\n<li>«Количество родов и абортов за гестационным возрастом» \n<li>«Количество новорожденных вакцинированных против гепатита В и БЦЖ»\n<li>«Средний койкодень»\n<li>«Количество родов по акушерских вмешательствах»\n</li></ul><li>В пункте меню «Отчеты» – «Статистические отчеты», в разделе «Информация о родах», отчетная таблица «Физиологические роды» переделана так, что теперь система считает «Физиологические роды» как все роды, кроме:\n</li><ul><li>Роды со сроком гестации до 37 недель (37 неделя не включается);\n<li>Роды с ягодичным предлежанием плода МКБ-10: O.32.1, O.64.1, O.80.1, O.83.1)\n<li>Роды с Кесаревым сечением (ургентным или плановым); \n<li>Если применялись следующие акушерские вмешательства:\n</li><ul><li>щипцы, \n<li>вакуум экстракция плода, \n<li>стимуляция родовой деятельности, \n<li>индукция родов, \n<li>ручное отделение плаценты; \n</li></ul><li>Кровотечение во время родов (МКБ-10: O.72 та O.72.0). 
NextVisit=Рекомендуемая дата следующего визита
Non_Physiological=Не физиологические
NoneRecorded=Нет
Notes=Примечание
NotetoTech=Запись для техника
NotificationInvalidTimeFormat=Используйте правильный формат времени.
notificationkeywords=Используйте следующие ключевые слова для каждого типа уведомлений:
notificationkeywordsHighriskpregnancysummary=Визит высокого риска напоминания для врачей: [report], [reportdate]
notificationkeywordspatientdischargedreferral=Пациент выписан из специализированной больницы: [patientname], [doctorname] , [facilityname], [dischargedate]
notificationkeywordsreminders=Напоминания для больных: [facilityname], [visitdate], [patientname]
notificationkeywordsremindersfordoctors=Визит высокого риска напоминания для врачей: [facilityname], [visitdate], [patientname], [doctorname]
NotificationNote=Пожалуйста, отключите, если пациент с помощью мобильного приложения МЧ-реестра.
notifications=Уведомления
NotificationsDayOfMonth=День месяца должен быть не менее 1 не может быть выше, чем 28.
NotificationsDaysAfter=Через несколько дней после должно быть не менее 1 не может быть выше, чем 20.
NotificationsDaysinAdvHighRiskReminders=Дней для напоминания высокого риска должны быть влияет тип поверхности 1 до 15.
notificationsedit=Редактировать уведомлений Тексты
notificationsettings=Настройки уведомлений
notificationsettingsnote=Для всех объектов без своих настройках, настройки по умолчанию из приложения Виль быть использованы.
NotificationsReminderDaysinAdvance=Дней для напоминания должны быть влияет тип поверхности 1 до 15.
notificationssmsconfiguration=Конфигурация СМС сервис
NotificationType=Тип Уведомление
Notperformed=Тест не проводился
NotUsed=Не применялась
nProtocol=протокол
nProvider=поставщик
NrBabiesID=Количество детей
NrDeliveries=Роды
Number_abortions_gestational_age=Количество абортов за гестационным возрастом
NumberOfDelivery=Регистрационный № истории родов
NumberPatients=Количество пациентов
obstetrical=Количество родов по акушерских вмешательствах
ObstetricAnamnesis=Акушерский анамнез
OutputFormat=Выходной формат
pagePatient=Страница Пациент
Partner_deliveries_inall_facilities=Партнерские роды во всех учреждениях
PartnerDelivery=Партнерские роды
PartnerDeliveryFacility=Партнерские роды
PartnerDeliveryReport=Партнерские роды по учреждениям
Partogram=Использование партограмм по учреждениям
PartogramDistrictPerFacilitiesReport=Использование партограмм по учреждениям
PartogramDistrictReport=Использование партограмм
PartogramFacility=Использование партограмм
Partograms_inAll_facilities=Использование партограмм во всех учреждениях
password=Пароль
patient=Пациент
Patient_Information=Информация о пациенте
Patient_RegDate=Дата постановки на учет
PatientBadHabbits=Другие факторы риска пациента
PatientDischargedReferral=Пациент выписан из специализированной больницы (врачам)
PatientDischargedReferralDaysAfter=Отправить заявку х дней после выписки
PatientID=Идетификационный № пациента
PatientList=Перечень пациентов
Patientm=пациента
patientname=Имя пациента
patientpregnancydelivery=Роды с группировкой по населенным пунктам
patients_diseases=Заболевания пациента
PatientsConsentForm=Форма согласия пациента
PatientsHospitalizationDiagnosis=Диагноз пациента при госпитализации
patientsintheregistry=Количество пациентов в базе данных
PComplicationDiseasesList=Послеродовые осложнения
Percent=Процент
personalInformation=Персональная информация
PhoneNumber=Номер телефона
phyisiological_delivery=Физиологические роды
Physiological=Физиологические
PhysiologicalDelivery=Физиологические роды
PhysiologicalDeliveryInAllFacilities=Физиологические роды во всех учреждениях
PhysiologicalDeliveryPerFacility=Физиологические роды по учреждениям
PictureFullSize=[Полный размер]
Pos=Поз
Position=Должность
PositionID=Должность
PositionName=Имя
PositionPatient=Должность
PossibleDischargeDiagnosis=Перечень диагнозов
PostalCode=Почтовый индекс
Pregnancies=Беременность
pregnancy=Беременность
pregnancy_outcome=Результат беременности
PregnancyFacilityName=Учреждение регистрации беременности
PregnancyID=№ беременности
PregnancyList=Перечень беременностей
Pregnancym=беременность
PregnancyOutcomeDistrict=Результат беременности, район
PregnancyOutcomeFacilities=Результат беременности по учреждениям
PregnancyOutcomeFacilitiesAll=Результат беременности во всех учреждениях
PregnancyOutcomeID=Результат беременности
pregnancypregnancytype=Беременностей
PregnancyRecNr=Регистрационный № карты беременной
PregnancyTypeID=Тип
PregnancyTypeName=Тип беременности
PregRegDate=Дата регистрации беременности
PregRisksReport=Факторы риска беременности
PregRisksReportAll=Факторы риска беременности - Всего
PregRisksReportLastVisit=Факторы риска беременности - последний визит
PreventionTaken=Принятые меры
PreviousDeliveries=Предидущие роды
PreviousPregnancies=Предидущие беременности
ProblemDescription=Описание проблемы
ProcedureName=Наименование процедуры
Procedures_Applied=Принятые вмешательства
Procedures_List=Акушерские вмешательства
Province=Область
ProvinceID=Область
ProvinceName=Области
provinceProvinceID=Область
provinces=Области
PurchaseDate=Дата приобретения
PurchasePrice=Закупочная цена
PwdReq=Пароль должен состоять из 8-и символов и содержать хотя бы одну маленькую букву, одну большую букву и одну цифру
reason=Причина
ReasonHospitalisationICD10ID=Причина госпитализации
RecomDelivery3rdLevel=Рекомендовано роды на третьем уровне
RecomFollowUpMedication=назначенные медикаменты
RecomFollowupMedications=назначенные медикаменты
Recommendation=Рекомендации
RecommendationNot=Рекомендация Уведомления
RecommendationNotifications=Рекомендация Уведомления
Recommendations=Рекомендации
recommendationsnotificationsedit=Редактировать Рекомендация
RecommendedDeliveryDate=Рекомендованая дата родов на 3-ем уровне
RecomObstetricExamination=Рекомендован акушерский осмотр
RecomObstetricExaminationDate=Рекомендованная дата акушерского осмотра
RecomRepeatedConsultation=Рекомендована повторная консультация
RecomRepeatedConsultationDate=Рекомендованная дата повторной консультации
RecomRepeatedHospitalisation=Рекомендована повторная госпитализация
RecomRepeatedHospitalisationDate=Рекомендованная дата повторной госпитализации
RefDelivery=Направлена на роды
Referral=Направление в учреждение регистрации беременности невозможно! Пожалуйста, используйте "Госпитализацию"
Referral1=Направление в учреждение регистрации беременности невозможно!
ReferralDate=Дата направления
ReferralDeptID=Отделение
ReferralFacility=Referral Facility
ReferralFacilityID=Учреждение
ReferralType=Направление во время визитов
ReferralTypeID=Тип направления
refLast30Days=Количество направлений в учреждение за последние 30 дней
ReminderNot=Напоминание Уведомления
Reminders=Напоминания
RemindersDaysInAdv=Количество дней отправить уведомление заранее
RemindersHighRisk=Напоминания для высокого риска посещений беременности (к врачам)
Replace=Заменить
report_delivery_method_district=Метод родоразрешения, район
report_delivery_partner_district=Партнерские роды, район
report_delivery_partogram_district=Использование партограмм, район
report_delivery_type_district=Тип родов, район
report_expected_date_of_delivery_facilities=Дата родов
Report_gestation=Количество родов и абортов за гестационным возрастом
Report_gestation1=Количество родов за гестационным возрастом
Report_Manufacturers_Suppliers=Изготовитель, поставщик Отчеты
report_visit_date2=Следующий визит
RespDoctor=Врач
Resuscitation=Реанимация
Rhesus=Резус
RiskGroup=Группа риска
risksreport=Риски Сообщить
RNA=не применяется (аборт)
RNo=Нет
room=Комната
Roomdesc=Описание комнаты
RoomID=Комната
Roomnb=№ комнаты
RYes=Да
ScreenningHypoth=Скрининг и гипотиреоз
ScreenningPUK=Скрининг на ФКУ
search=Поиск
Search_Facilties=Учреждения
SearchPatient=Поиск пациента
SecondChild=Второй новорожденный
SelectLanguage=Язык
SerialNumber=Серийный номер
Services=Услуги
SessionExp=Сеанс окончен
Sex=Пол
SkinToSkin=Контакт кожа к коже
StateOrProvince=Район
Statistical_reports_facility=Статистические отчеты
Statistical_reports_for_district_level=Статистические отчеты
Statistical_reports_for_facility_level=Статистические отчеты
Status=Статус
Steroids=Стероиды
Stillbirths=Родились мертвыми
Street_Name=Улица
StreetName=Улица
StreetNameN=Улица, № дома/кв.
SubscribeMessage=Подписаться сообщение
Sum=Сумма:
Supplier=поставщик
SupplierContactID=Контакт
SupplierID=поставщик
SupplierIDList=поставщик
SupplierName=Название
Suppliers=поставщик
suppliervendor=Продавец от поставщика
Surfactant=Сурфактант
SWVersion=Версия програмного обеспечения
TechnicianYN=Техник Да/Нет
TermsOfUse=Условия использования
test=Тест
test56=Тест
TestDate=Дата теста
testhospitalisation=тест
TestName=Название теста
TestResult=Результат теста
TestResultDetails=Детальный результат теста
TestResultNormal=Результат теста нормальный?
Tests=Тесты
testsbutton=тести
testtestcode=тестов
testv=тест
Text=текст
Text3= 
ThirdChild=третий новорожденный
TimeToSend=Время для отправки уведомления
to=по
Today=Сегодня
Total=Всего
Town=населенный пункт
TownVillage=населенный пункт
TransferredPatient=Переведена на роды (в другое учреждение)
TreatedNICU=Лечение в NICU
turnout=Явка пациента на дату
Ultrasound20weeks=УЗИ до 22 недель
UMDNS=UMDNS код
Unemploed=Безработная
unicodeSMS=Unicode SMS
UnsubscribeMessage=Отказаться от подписки Сообщение
UploadImages=Загрузить изображение
UploadUserImages=Загрузить изображение нового пользователя
Used=Применялась
UserData=Данные пользователя
username=Имя пользователя
UserResources=Ресурсы для пользователя
Uterotoics=Утеротоники
Utilization=Использование
vaccinated=Количество новорожденных вакцинированных против гепатита В и БЦЖ
VaccinationBCG=Вакцинация БЦЖ
VaccinationHepB=Вакцинация гепатит В
ValidInputForNotifications=Действительное время: с 6:00 до 22:00 каждые полчаса. <br>инструменты\nДействительно день (дни) заранее / до: 1-7 дней.
Vendor=Продавец
VendorIDList=Продавец
Visit=визит
VisitDate=Дата визита
VisitOutcomeID=Результата визита
VisitOutcomeName=Результат
visitpatient=Визит, Пациент
visitreferralpregnancypatientemployees=Визиты
Visits=Визиты
VisitType=Тип визита
Warranty=Гарантия
WarrantyContract=Гарантия или Договор
WarrantyContractExp=Окончание гарантийного Договора
WarrantyContractID=Гарантия или Договор
WarrantyContractNotes=Примечания гарантийного Договора
Wassermann=Вассерман
Weight=Масса тела (кг.)
Weight1=Масса тела (г.)
Woman=ж
WOPartCost=WOPart Cost
WorkorderNo=Нет
workorders=Workorders
WorkPhone=Рабочий телефон
WorkPriorityID=Work Priority ID
WorkStatusID=Work Status ID
WorkTypeID=Work Type ID
WOTrade=WOTrade
XVOR_ID=XVOR ID
Zipcode=` Zip-code`
approxRemaining=Приближение только если используются ключевые слова!
notificationkeywordssubscribeunsubscribe=Подписаться и Отказаться: [patientname], [doctorname] , [facilityname]
Unsubscribe=Отказаться Уведомление
Subscribe=Подписаться Уведомление
SubscribeDaysAfter=Отправить х дней после подписки
UnsubscribeDaysAfter=Отправить х дней после отписку
NotificationID=ID
